error	gold
Pankaj	Pankaj
Pakaj	Pankaj
PANKAJ	Pankaj
Panakj	Pankaj
Paankaj	Pankaj
Pria	Priya
PRIYA	Priya
rPiya	Priya
Pryiaa	Priya
Priiya	Priya
AAam	Aam
Aa	Aam
AAM	Aam
aAam	Aam
Ama	Aam
eLela	Leela
eela	Leela
Leeeela	Leela
Leeela	Leela
LEELA	Leela
ANJALI	Anjali
Anjaalii	Anjali
Anjal	Anjali
Anjlai	Anjali
AAjnalii	Anjali
RAHUL	Rahul
Rahuul	Rahul
Rhaul	Rahul
aRhul	Rahul
Rahu	Rahul
nAaand	Anand
Annad	Anand
Anan	Anand
ANAND	Anand
AAnaand	Anand
Roohan	Rohan
Rohan	Rohan
Roahn	Rohan
Rohn	Rohan
ROHAN	Rohan
Riut	Ritu
Rit	Ritu
RITU	Ritu
Riitu	Ritu
Riituu	Ritu
Radhiak	Radhika
RADHIKA	Radhika
Raadhiikaa	Radhika
Radhka	Radhika
Raadhika	Radhika
Sahil	Sahil
Sahli	Sahil
SAHIL	Sahil
Shail	Sahil
ahil	Sahil
Ysah	Yash
Yash	Yash
Yas	Yash
YASH	Yash
Yahs	Yash
SHAKTI	Shakti
Shakit	Shakti
Shaaktii	Shakti
Shkti	Shakti
ALOK	Alok
Alk	Alok
AAlko	Alok
lAok	Alok
AAlook	Alok
Bahnu	Bhanu
Bhan	Bhanu
Bhanuu	Bhanu
BHANU	Bhanu
KAVITA	Kavita
Kavia	Kavita
aKviitaa	Kavita
Kvaita	Kavita
Kavitaa	Kavita
Geeta	Geeta
Geeat	Geeta
GEETA	Geeta
Geeetaa	Geeta
eeta	Geeta
Rekha	Rekha
Reka	Rekha
REKHA	Rekha
Rkeha	Rekha
Rekhaa	Rekha
Kjaal	Kajal
Kaaajal	Kajal
Kaajal	Kajal
KAJAL	Kajal
Kaal	Kajal
PRITI	Priti
Priiti	Priti
Pirti	Priti
Piti	Priti
rPitii	Priti
nSeha	Sneha
SNEHA	Sneha
neha	Sneha
Sneha	Sneha
Rameehs	Ramesh
Rameh	Ramesh
Rameesh	Ramesh
aRmesh	Ramesh
RAMESH	Ramesh
Kira	Kiran
Kiiarn	Kiran
Krian	Kiran
Kiiran	Kiran
KIRAN	Kiran
sha	Asha
sAha	Asha
AAsaha	Asha
ASHA	Asha
AAsha	Asha
Sures	Suresh
SURESH	Suresh
Suureesh	Suresh
Surseh	Suresh
uSresh	Suresh
Dviya	Divya
Diivya	Divya
Dviyaa	Divya
DIVYA	Divya
Dvya	Divya
Suinl	Sunil
Suunil	Sunil
SUNIL	Sunil
Sunli	Sunil
Sunl	Sunil
Devika	Devika
DEVIKA	Devika
eDvika	Devika
Dvika	Devika
Deviikaa	Devika
Saviita	Savita
SAVITA	Savita
Saviitaa	Savita
Savta	Savita
Svaita	Savita
Kuumar	Kumar
Kuumaar	Kumar
KUMAR	Kumar
Kuma	Kumar
Kumra	Kumar
